O.?####..#
....###oe+
.##.?...$=
^#iI$.###=
...^#...#$
..+&####.#
+a#$?#?+#A
..^.+.#.#?
....#+$E^#
.$=====.##
