..?.?.?#A.
???.$#$.#.
.^^a..#?#$
.#.#..##.#
#====+#o.+
#+.##.#===
.#..^.#..A
.O#E..$##.
.?##^#..#e
?#.##.#a.$
