.#.^#E#..#
^.#.##?...
^#.?#.O#?.
#A.?e.##=+
#.^.+$^#=.
##..#^#.&&
.?#+?.^#?.
.&##..#.$.
++^..#?.oa
#?..^^??##
