....###.##
.$Ae&e#^##
.#?#^.+..#
$#....##a.
$#.#..A#..
#..E#??#..
^##E.#o#.i
##?O^E###.
#?e#^?I###
+.#a..###.
