?#.###$=##
..#o?+#=^#
?#+?.##=$.
##??a.+?.#
I#..A?====
.###$##.#&
..i#.+#$#.
?#.##=?###
#&.O#=#?##
..#..=$?##
