$#&#.$....
#+.^.+.#..
###^#..Ei.
##I?.^..?+
E.#....#I.
#..##+.^$#
#.#o.#e?##
?+O==+.^..
##$..e?..i
#?^e#&#.E#
