.IO.#....#
#.+.......
..####.^##
=+^+.###..
=.#^.#+#^^
=#.?^.#.#&
=$o..$...#
##.#..###+
+#ei.?..iE
#+##.I#.#.
