.$&.#o#..#
##^##..#^#
?##^##.?..
&##&#e.#..
^#..#.#?##
#...#+?#..
?#^#..?#..
.^.##.##..
######I###
.i&i..^^#O
