^.?#^.#.?^
.I...#.#..
..#?#^$?##
^==..#==.#
^&$&^?#O.#
#...#.^ao.
A?...#Ai#.
..##a....#
#.$##&##.#
^.#....##.
