.a###A..#?
.#.^.#.=+#
..?.#e.=?#
#..###.=##
#...##+=.E
$o^##.....
=..##..O#i
=$..Aa$##e
=&I#..?.#^
=+#...E##?
