#.####.#..
?&##.#$&#O
?^#o.#..#e
..#.#??...
^.##.E..#?
##.#^?.&.#
^+.##.+..#
^e^##.E...
....#i...#
.^.#.+^.&I
