#.#.$.#&#.
.O##.#^#?+
A&.=$###..
...=.#^...
?.E=#+.#..
#^&=.#.^&.
##a.#.?###
##e?#o.aa.
?^#A^^.#..
A#.#.##.##
