....O.$i.#
^..###.#??
?#...##.##
#A##^.^...
.^###..#..
?^a#....#^
#.#I=$.##.
##^#=##E.o
?.^#=$#$#?
#ee#^.^#^.
