#.?O..^#..
#?.#?##&?&
.#?#.##===
#..#&#$#..
.?.##?####
##.#+=.eo?
+.A^.#=.#.
#i+.#^.=#.
#a===.E#=.
#?##&#^.&=
