.+##o=#.#.
###..=^###
#.$.#=&.#&
...#.====O
.#.##&##.$
#####.i#.#
$^#a.A#E.#
&#.^.^&#^.
??I^.^$==^
##.&.#.+$.
