#.#a...#+$
.&..#.A#?#
#.##A##&&o
.##.?$#===
#?####a###
##..??#O#A
.#..^....#
#.#..#ia?#
.I$....##^
.#^#eE?#..
