#.????=$$^
..a+i?=I#^
A^##?=$#?#
+#$O#=#.o.
...i.=##.#
.$$&^$.a..
#+==#.?#.#
####.#i.##
#.I^###I$#
?A.$..#^#^
