.##...^?^.
....A.##Oa
.#.##...&#
?^?.A#.?..
.#.#######
?$.^#.===+
...$a#&i^#
##^=.#..##
#.#=&^#..#
#o..I.#aA.
