^.?^.#.&#.
###O####?+
#..##^.#.$
#...###...
.E.#?.#.?#
#?#?.^.i.#
==+##?#.##
+.##?....?
.#+..e#^..
...#o##.I.
