...====$..
&$#++.#$^.
=====??#..
..##.?#O=.
#....?#?=$
..#^#.#^=&
##^?.###+^
#i....I#..
.##.##o&##
...$^.###.
