===^##A+.#
$.+O.?##.#
#?...$?#..
$.##..#.#$
^??..&##==
##.^##..&+
#.#+?.#?#.
..##.#o===
.?^....&#$
##^^.##a.#
