#A#.#?#.#O
$?##.A..+a
.######?==
?.&#...?.$
###^...#.?
##^#...##o
#.?#^=====
..##.&##..
..?a.#.##.
^^..##.#+#
