.###.$..^&
&&^.$#.#^#
e#..e.#^##
..#.^..###
+#&$.&#.#o
.##.#...#.
..^#......
.##..#.^^#
.##.E?E.&#
.$#..##.O#
