#.##?##.A.
#..&#^o^#.
+&#$..#+#.
##^.#I?a^#
^.#O#?#.^&
+..?#&#I##
i&..#$.#$#
?.&.#i...#
^#$#..?.##
.##.##?#.$
