+..A..#^..
##^+.##...
#aO##$$.?#
#....o$..$
..^^+#..##
e====#.^.#
.&?...?#.?
.^?####Ei.
.+.#$..#.&
.##.##?I?&
