#^#.?.##..
..###.##?&
#...#...#.
.$+.?##O^.
#########.
.#$...o&#i
..##.#^&..
#...?.#..#
##.#II?#..
i#.Ii.#.#?
