&.#^#..?.?
#o.^..&#..
#.&==&?.##
$.^.#.#$=#
?...##?.=.
?.##?a#&=+
###^E.#?A.
?^.A?.a#A#
#?.#?.a^$.
+##e?..^.O
