.#E.A.#o&=
#.A?...#&=
..###..=$I
$a.#&a?=#I
==##?.#=.#
+$$.aO#=$#
.i&e^#a^.#
#?#....#i#
^.?##...#A
..^#^A####
