..^.A.####
^+.I#^##a#
+&....#I.#
&$.#.i####
^.^#?^..&#
e#i....#i.
.#^###$o.O
#$##..##&.
.a#..aE#&A
A.#.ea#IAE
