.^#+####^.
#..#+#$..#
.&^$^##..#
+.e#.++.^#
$O#.....#.
E^.A#?#..$
.....#a#.?
.......A.#
..e#E?a##i
o==$I^.##.
