^.##.#..?I
#$##.##.##
.##&=##..#
.#$.=+..#.
+..&=====.
O#^?.###&#
^#+#.$?.^#
&$#&#.+#?#
..#..###..
#i..e....o
