^#?..#?^.^
#?.O.##^.#
...+^.#^..
..#$...&+?
#?#.#o^...
$..&##....
I...A^+.##
#a#.#.#i..
##.#.+.#.#
####.A##a.
