O....##?..
.+.&&..##.
.^###$#^#.
.###...###
...#^.^##.
==##..#..$
$&^.#.####
#$.+.++#$?
#?#??#?##.
?#..#o#.#+
