#.###.#.#.
^?^#....#&
#.#O....==
.##^.##?+&
.?#.?.##&=
#?.##...#=
...?^A#..=
.#..##..#=
#...##.#ao
?.+^+##.^^
