..?.O.$=^.
^^$#.##=$.
##=#?###^.
.o=.#i?I+.
.#=#.#Ii^.
##$#.##E..
?^#&#^#.##
#.#e#.##^I
..&#$^.&#.
?.====$#$i
