&..##.a.$=
#.##.I.o+=
e#AO^.^##^
#..#?.#..$
A.##$.a..?
.#...##.##
E.+.A#..#.
#^??#ie#?#
E#Ii#ei.a.
I.....I$#i
