=+.o.#E.+.
====.##.##
+..$..#..#
#$##E..#$.
#e??I#?##.
###e#..#O.
.#.#i###E#
?##....+#^
.##.#...#?
e?.^.##.#.
