io?.^.+.i#
.....^#.OI
+#.?#.#.#+
A#.#?&?.#.
.+.#...+#.
?.#..#?.#+
..i...^#?^
+.I#.$#..#
##...^..a&
##^#?#.#Ie
