O.#^.^#?##
$?#.?##..#
.#^#.#a##^
..$.#+.^#.
#^....#.^#
..+##.^o.#
##$A?#.A##
.#?$#&##.a
.?##.#.##.
.##..?#.?#
