#+##..#.##
..^#.i..##
#^#.##^#&.
...^#.$.##
#.I.+####.
#.?o..&..#
.#=====#^+
.#+#.^#+#^
I&#^#.#^i.
#.##..##O.
